1111111111111111
1000000000000001
100E00C00E00P001
1000000000000001
1111111111111111
